1111111111111111111111
1P0000100000C000000001
1011101011111111111101
101C00E0000C1CCC00CCC1
1000101111101C0C0BC0C1
1111101000001CCC00CCC1
1000001C1111100C00C001
101111100000100CCCCB01
101000111110100C00C001
10001000000C1CCCB0CCC1
1111111111111111111111