1111111111111111111111111111111111
1E0000010000000C00000C000100000001
1010010100100000101001001000010101
10100100101010100010010000B0010101
1P0000000C00C0000000B00000000000C1
1111111111111111111111111111111111